eo
--
-o
--
os
--
###
--o-o-o-
-o-s-o-o
--o-o-o-
--e---oo
###
o-ooo-o-
-o-o-o-o
o-o-o-o-
-o-o-o-o
o-o-o-o-
-o-o-o-o
o-s-o-o-
-e-o-o-o
###
et-
---
-oT
---
-s-
---
###
o-o-o-oo
-s-o-o-U
o-o-o---
--u----o
---o-o--
e-t----T
###