--o-o-o-
-o-s-o-o
--e-o-o-
------tT
###
o-ooo-o-
-o-o-o-o
o-o-o-o-
-o-o-o-o
o-o-o-o-
-o-o-o-o
o-s-o-o-
-e-o-o-o
###
--o-o-o-
-o-s-o-o
--o-e-o-
------oo
###